11111111111111111111111111111111111111111111
100000000000000C00000C00000000E0000000000001
10100101001000001010010000010000000000000001
10100101001000001010010000010000000000000001
10100101001000001010010000010000000000000001
10100101001000001010010000010000000000000001
10100101001000001010010000010000000000000001
10100101001000001010010000010000000000000001
10100101001000001010010000010000000000000001
10100101001000001010010000010000000000000001
10100101001000001010010000010000000000000001
10100101001000001010010000010000000000000001
10100101001000001010010000010000000000000001
10100101001000001010010000010000000000000001
10100100101010100010010000010000000000000001
10100100101010100010010000010000000000000001
10100100101010100010010000010000000000000001
10100100101010100010010000010000000000000001
10100100101010100010010000010000000000000001
10100100101010100010010000010000000000000001
10100100101010100010010000010000000000000001
10100100101010100010010000010000000000000001
1P0000000C00C0000000000000010000000000000001
11111111111111111111111111111111111111111111